/*******\
*       *
*       *
*       *
*       *
*       *
*       *
*       *
*       *
\*******/
