/********\
*        *
*        *
*        *
*        *
*        *
*        *
*        *
\********/
