/******\
*      *
*      *
*      *
*      *
*      *
*      *
*      *
*      *
\******/
